FileVersion,1
Sprites,64
SpriteSize,256,256,4,64
Colorselector,0,0,0,0
Colorselector,1,128,0,0
Colorselector,2,0,128,0
Colorselector,3,128,128,0
Colorselector,4,0,0,128
Colorselector,5,128,0,128
Colorselector,6,0,128,128
Colorselector,7,192,192,192
Colorselector,8,128,128,128
Colorselector,9,255,0,0
Colorselector,10,0,255,0
Colorselector,11,255,255,0
Colorselector,12,0,0,255
Colorselector,13,255,0,255
Colorselector,14,0,255,255
Colorselector,15,255,255,255
Colorselector,16,0,0,0
Colorselector,17,8,8,8
Colorselector,18,16,16,16
Colorselector,19,24,24,24
Colorselector,20,32,32,32
Colorselector,21,40,40,40
Colorselector,22,48,48,48
Colorselector,23,56,56,56
Colorselector,24,64,64,64
Colorselector,25,72,72,72
Colorselector,26,80,80,80
Colorselector,27,88,88,88
Colorselector,28,96,96,96
Colorselector,29,104,104,104
Colorselector,30,112,112,112
Colorselector,31,120,120,120
Colorselector,32,128,128,128
Colorselector,33,136,136,136
Colorselector,34,144,144,144
Colorselector,35,152,152,152
Colorselector,36,160,160,160
Colorselector,37,168,168,168
Colorselector,38,176,176,176
Colorselector,39,184,184,184
Colorselector,40,192,192,192
Colorselector,41,200,200,200
Colorselector,42,208,208,208
Colorselector,43,216,216,216
Colorselector,44,224,224,224
Colorselector,45,232,232,232
Colorselector,46,240,240,240
Colorselector,47,248,248,248
Colorselector,48,42,26,10
Colorselector,49,64,42,21
Colorselector,50,74,53,24
Colorselector,51,110,70,32
Colorselector,52,90,70,70
Colorselector,53,130,90,90
Colorselector,54,160,100,76
Colorselector,55,160,130,120
Colorselector,56,192,128,64
Colorselector,57,192,148,100
Colorselector,58,180,160,160
Colorselector,59,200,180,170
Colorselector,60,224,160,96
Colorselector,61,230,192,112
Colorselector,62,234,192,160
Colorselector,63,240,208,176
Colorselector,64,0,0,0
Colorselector,65,0,0,28
Colorselector,66,0,0,56
Colorselector,67,0,0,84
Colorselector,68,0,18,0
Colorselector,69,0,18,28
Colorselector,70,0,18,56
Colorselector,71,0,18,84
Colorselector,72,0,36,0
Colorselector,73,0,36,28
Colorselector,74,0,36,56
Colorselector,75,0,36,84
Colorselector,76,0,54,0
Colorselector,77,0,54,28
Colorselector,78,0,54,56
Colorselector,79,0,54,84
Colorselector,80,28,0,0
Colorselector,81,28,0,28
Colorselector,82,28,0,56
Colorselector,83,28,0,84
Colorselector,84,28,18,0
Colorselector,85,28,18,28
Colorselector,86,28,18,56
Colorselector,87,28,18,84
Colorselector,88,28,36,0
Colorselector,89,28,36,28
Colorselector,90,28,36,56
Colorselector,91,28,36,84
Colorselector,92,28,54,0
Colorselector,93,28,54,28
Colorselector,94,28,54,56
Colorselector,95,28,54,84
Colorselector,96,56,0,0
Colorselector,97,56,0,28
Colorselector,98,56,0,56
Colorselector,99,56,0,84
Colorselector,100,56,18,0
Colorselector,101,56,18,28
Colorselector,102,56,18,56
Colorselector,103,56,18,84
Colorselector,104,56,36,0
Colorselector,105,56,36,28
Colorselector,106,56,36,56
Colorselector,107,56,36,84
Colorselector,108,56,54,0
Colorselector,109,56,54,28
Colorselector,110,56,54,56
Colorselector,111,56,54,84
Colorselector,112,84,0,0
Colorselector,113,84,0,28
Colorselector,114,84,0,56
Colorselector,115,84,0,84
Colorselector,116,84,18,0
Colorselector,117,84,18,28
Colorselector,118,84,18,56
Colorselector,119,84,18,84
Colorselector,120,84,36,0
Colorselector,121,84,36,28
Colorselector,122,84,36,56
Colorselector,123,84,36,84
Colorselector,124,84,54,0
Colorselector,125,84,54,28
Colorselector,126,84,54,56
Colorselector,127,84,54,84
Colorselector,128,0,0,0
Colorselector,129,0,0,56
Colorselector,130,0,0,112
Colorselector,131,0,0,168
Colorselector,132,0,40,0
Colorselector,133,0,40,56
Colorselector,134,0,40,112
Colorselector,135,0,40,168
Colorselector,136,0,80,0
Colorselector,137,0,80,56
Colorselector,138,0,80,112
Colorselector,139,0,80,168
Colorselector,140,0,120,0
Colorselector,141,0,120,56
Colorselector,142,0,120,112
Colorselector,143,0,120,168
Colorselector,144,56,0,0
Colorselector,145,56,0,56
Colorselector,146,56,0,112
Colorselector,147,56,0,168
Colorselector,148,56,40,0
Colorselector,149,56,40,56
Colorselector,150,56,40,112
Colorselector,151,56,40,168
Colorselector,152,56,80,0
Colorselector,153,56,80,56
Colorselector,154,56,80,112
Colorselector,155,56,80,168
Colorselector,156,56,120,0
Colorselector,157,56,120,56
Colorselector,158,56,120,112
Colorselector,159,56,120,168
Colorselector,160,112,0,0
Colorselector,161,112,0,56
Colorselector,162,112,0,112
Colorselector,163,112,0,168
Colorselector,164,112,40,0
Colorselector,165,112,40,56
Colorselector,166,112,40,112
Colorselector,167,112,40,168
Colorselector,168,112,80,0
Colorselector,169,112,80,56
Colorselector,170,112,80,112
Colorselector,171,112,80,168
Colorselector,172,112,120,0
Colorselector,173,112,120,56
Colorselector,174,112,120,112
Colorselector,175,112,120,168
Colorselector,176,168,0,0
Colorselector,177,168,0,56
Colorselector,178,168,0,112
Colorselector,179,168,0,168
Colorselector,180,168,40,0
Colorselector,181,168,40,56
Colorselector,182,168,40,112
Colorselector,183,168,40,168
Colorselector,184,168,80,0
Colorselector,185,168,80,56
Colorselector,186,168,80,112
Colorselector,187,168,80,168
Colorselector,188,168,120,0
Colorselector,189,168,120,56
Colorselector,190,168,120,112
Colorselector,191,168,120,168
Colorselector,192,0,0,0
Colorselector,193,0,0,85
Colorselector,194,0,0,170
Colorselector,195,0,0,255
Colorselector,196,0,85,0
Colorselector,197,0,85,85
Colorselector,198,0,85,170
Colorselector,199,0,85,255
Colorselector,200,0,170,0
Colorselector,201,0,170,85
Colorselector,202,0,170,170
Colorselector,203,0,170,255
Colorselector,204,0,255,0
Colorselector,205,0,255,85
Colorselector,206,0,255,170
Colorselector,207,0,255,255
Colorselector,208,85,0,0
Colorselector,209,85,0,85
Colorselector,210,85,0,170
Colorselector,211,85,0,255
Colorselector,212,85,85,0
Colorselector,213,85,85,85
Colorselector,214,85,85,170
Colorselector,215,85,85,255
Colorselector,216,85,170,0
Colorselector,217,85,170,85
Colorselector,218,85,170,170
Colorselector,219,85,170,255
Colorselector,220,85,255,0
Colorselector,221,85,255,85
Colorselector,222,85,255,170
Colorselector,223,85,255,255
Colorselector,224,170,0,0
Colorselector,225,170,0,85
Colorselector,226,170,0,170
Colorselector,227,170,0,255
Colorselector,228,170,85,0
Colorselector,229,170,85,85
Colorselector,230,170,85,170
Colorselector,231,170,85,255
Colorselector,232,170,170,0
Colorselector,233,170,170,85
Colorselector,234,170,170,170
Colorselector,235,170,170,255
Colorselector,236,170,255,0
Colorselector,237,170,255,85
Colorselector,238,170,255,170
Colorselector,239,170,255,255
Colorselector,240,255,0,0
Colorselector,241,255,0,85
Colorselector,242,255,0,170
Colorselector,243,255,0,255
Colorselector,244,255,85,0
Colorselector,245,255,85,85
Colorselector,246,255,85,170
Colorselector,247,255,85,255
Colorselector,248,255,170,0
Colorselector,249,255,170,85
Colorselector,250,255,170,170
Colorselector,251,255,170,255
Colorselector,252,255,255,0
Colorselector,253,255,255,85
Colorselector,254,255,255,170
Colorselector,255,255,255,255
spritebank,0
SpriteStart
SpriteBitmapBlock,0,16,256
10,10,10,10,10,10,10,10,10,10,10,10,10,10,10,10,10,10,10,10,10,10,10,10,11,11,11,11,11,11,11,11,10,10,3,11,11,11,11,11,10,10,10,10,10,10,10,10,10,10,10,10,10,10,10,10,11,11,11,11,11,11,11,10,10,10,10,10,10,10,10,3,11,10,10,3,11,10,3,11,11,11,10,10,10,3,11,11,11,10,10,10,10,10,10,10,10,10,10,10,10,10,3,11,10,10,11,11,11,10,3,11,10,10,10,10,10,10,10,10,11,10,10,10,10,10,10,10,7,7,7,7,7,7,7,7,8,8,8,8,8,8,8,8,8,3,3,3,3,3,8,8,3,3,3,8,3,3,10,10,3,3,3,3,3,3,3,3,10,10,10,10,3,10,10,10,10,8,8,10,10,10,8,10,3,3,3,3,3,3,3,3,3,8,3,3,3,3,8,10,3,3,3,3,3,3,3,3,10,8,3,3,3,3,3,3,3,3,3,3,3,3,3,8,10,10,8,10,10,10,8,10,10,10,10,8,8,8,10,10,3,3,3,3,3,3,3,3,3,3,3,3,3,3,3,3
10,10,10,10,10,10,10,10,10,10,10,10,10,10,10,10,10,10,10,10,10,10,10,10,11,11,11,11,11,11,11,11,10,10,3,11,11,11,11,11,10,10,3,10,10,10,10,3,11,10,10,3,10,3,10,10,11,11,11,11,11,11,10,10,10,10,10,10,10,10,3,11,10,10,10,10,3,10,10,3,11,10,10,10,10,10,3,11,11,10,10,10,10,10,10,10,10,10,10,10,10,10,3,11,10,10,10,10,3,10,10,3,10,10,10,10,10,10,10,10,11,10,10,10,10,10,10,10,7,7,7,7,7,7,7,7,7,15,15,15,7,15,15,7,10,8,3,3,3,8,3,3,3,3,8,3,3,3,3,10,3,3,3,8,3,8,3,3,3,10,3,3,3,3,3,3,8,3,3,8,8,8,3,8,3,8,3,3,3,3,8,3,3,3,8,3,3,3,3,8,10,3,8,8,3,3,3,8,10,8,3,3,8,8,3,3,3,8,8,8,8,3,3,8,10,8,3,8,8,8,3,8,8,8,8,3,3,3,8,10,3,3,8,3,3,3,3,3,3,3,3,3,8,8,3,3
10,10,10,10,10,10,10,10,10,2,10,10,10,2,10,10,10,10,10,10,10,10,10,10,11,11,11,11,11,11,11,11,10,10,10,3,11,11,11,11,10,3,11,11,10,10,3,11,11,11,11,11,11,11,11,10,11,11,11,11,11,11,10,10,10,10,10,10,10,10,3,11,10,10,10,10,10,10,10,3,10,10,10,10,10,10,10,10,10,10,10,10,10,10,10,10,10,10,10,10,10,10,10,3,10,10,10,10,10,10,10,10,10,10,10,10,10,10,10,10,11,11,10,10,10,10,10,10,7,15,15,15,7,15,15,7,7,7,7,7,7,7,7,7,10,10,3,8,8,3,3,3,3,8,3,3,3,3,3,3,3,8,3,8,3,3,3,3,3,3,3,3,8,3,3,3,3,3,3,3,3,3,3,3,3,3,3,3,8,3,8,3,3,3,3,8,8,3,3,8,10,3,3,3,8,3,3,3,8,3,3,8,3,3,8,3,3,3,3,3,3,3,8,10,10,8,3,3,3,3,3,3,3,3,3,3,3,8,3,8,3,3,3,8,8,3,3,3,3,3,8,3,3,3,3,3
10,10,10,10,10,10,10,10,10,10,2,10,2,10,10,10,10,10,10,10,10,10,10,10,11,11,11,11,11,11,11,11,10,10,10,3,11,11,11,11,10,10,3,11,11,11,11,11,11,11,11,11,11,11,10,10,11,11,11,11,11,11,11,10,10,10,10,10,10,10,10,3,10,10,10,10,10,10,3,11,11,10,10,10,10,10,10,10,10,10,10,10,10,10,10,10,10,10,10,10,10,10,10,3,10,10,10,10,10,10,10,10,10,10,10,10,10,10,10,10,11,10,10,10,10,10,10,10,8,8,8,8,8,8,8,8,7,7,7,7,7,7,7,7,10,8,3,3,3,3,8,3,3,3,3,8,3,3,3,10,3,8,3,8,3,3,8,3,3,8,3,3,8,3,8,3,3,3,8,3,8,3,3,3,3,8,3,3,8,3,8,3,8,3,3,3,3,3,3,8,10,3,3,3,3,8,3,3,10,8,3,3,8,3,8,3,3,8,3,8,3,3,8,10,8,3,3,8,3,3,8,3,3,8,3,3,8,3,3,8,8,3,3,3,3,8,3,3,3,8,3,3,3,3,8,3
10,10,10,10,10,10,10,10,10,10,2,10,2,10,10,10,10,10,10,2,10,10,10,2,11,11,11,11,11,11,11,11,10,10,3,11,11,11,11,11,10,3,11,11,11,11,11,11,11,11,11,11,11,10,10,10,11,11,11,11,11,11,10,10,10,10,10,10,10,10,10,3,10,10,10,10,10,10,3,11,10,10,10,10,10,10,10,10,10,10,10,10,10,10,10,10,10,10,10,10,10,10,3,11,10,10,10,10,10,10,10,10,10,10,10,10,10,10,10,10,10,10,10,10,10,10,10,10,7,7,7,7,7,7,7,7,8,8,8,8,8,8,8,8,8,3,3,8,8,3,3,3,3,3,8,3,3,3,10,10,3,8,3,8,3,3,8,3,3,8,3,8,8,3,8,3,3,3,8,3,3,8,3,3,3,8,3,3,8,3,3,3,3,8,3,3,3,3,8,10,3,3,8,3,3,3,3,3,10,10,8,3,3,3,8,3,3,8,3,3,8,3,8,10,10,8,3,3,8,3,8,3,3,8,3,3,3,3,3,8,3,3,8,3,3,3,3,3,3,3,3,3,3,8,3,3
10,10,10,10,10,10,10,10,10,10,10,10,10,10,10,10,10,10,10,10,2,10,2,10,11,11,11,11,11,11,11,11,10,3,11,11,11,11,11,11,10,10,3,11,11,11,11,11,11,11,11,11,11,10,10,10,11,11,10,10,3,11,11,10,10,10,10,10,10,10,3,11,10,10,10,10,10,10,10,3,10,10,10,10,10,10,10,10,11,10,10,10,10,10,10,10,10,10,10,10,10,3,11,11,10,10,10,10,10,10,10,10,10,10,10,10,10,10,10,10,10,10,10,10,10,10,10,10,7,7,7,7,7,7,7,7,7,15,15,15,7,15,15,7,8,3,3,3,3,8,8,3,3,3,3,3,3,3,10,10,3,3,3,3,8,3,3,3,3,8,3,3,8,3,8,3,3,8,8,3,3,8,3,3,3,3,3,3,3,3,3,3,3,3,8,3,3,3,8,10,3,3,3,8,3,3,3,8,10,8,3,3,3,3,3,3,3,3,3,3,3,3,8,10,10,8,3,3,3,3,8,3,3,3,3,3,3,3,8,10,3,3,3,8,8,3,3,3,3,3,8,8,8,3,3,3
10,10,10,10,10,10,10,10,10,10,10,10,10,10,10,10,10,10,10,10,2,10,2,10,11,11,11,11,11,11,11,11,10,10,3,10,3,10,10,3,10,10,3,11,11,11,11,11,11,11,11,11,11,11,10,10,10,10,10,10,10,3,10,10,10,10,10,10,10,10,10,3,10,10,10,10,10,10,10,3,11,10,10,10,10,10,10,10,11,10,10,10,10,10,10,3,10,10,10,10,10,10,3,11,10,10,10,10,10,10,10,10,10,10,10,10,10,10,10,10,11,10,10,10,10,10,10,10,7,15,15,15,7,15,15,7,7,7,7,7,7,7,7,7,10,8,3,8,8,3,3,3,3,3,3,8,8,3,3,10,8,3,8,8,10,8,8,8,3,8,3,3,8,3,3,3,3,3,8,3,3,3,3,3,3,3,3,3,3,3,3,3,3,3,3,8,8,3,8,10,3,3,3,3,8,8,3,3,10,8,3,8,8,3,3,8,8,8,3,3,3,8,10,10,10,8,3,8,8,3,3,3,3,3,8,8,8,3,8,10,3,3,3,3,3,8,8,3,3,3,3,3,3,3,3,3
10,10,10,10,10,10,10,10,10,10,10,10,10,10,10,10,10,10,10,10,10,10,10,10,11,11,11,11,11,11,11,11,10,10,10,10,10,10,10,10,10,3,11,11,11,11,11,11,11,11,11,11,11,11,10,10,10,10,10,10,10,10,10,10,11,10,3,11,11,10,3,11,10,10,10,10,10,10,10,3,11,10,10,10,10,10,10,10,11,11,11,10,10,3,11,11,10,10,10,10,10,10,10,3,10,10,10,10,10,10,10,10,11,11,10,10,3,11,10,3,11,10,10,10,10,10,10,10,8,8,8,8,8,8,8,8,7,7,7,7,7,7,7,7,10,8,3,3,3,3,8,3,3,3,8,3,3,3,3,10,10,8,10,10,10,10,10,10,3,3,3,3,3,3,3,3,3,3,3,3,3,3,3,3,3,10,10,3,3,3,10,3,3,3,3,3,3,3,3,8,10,3,3,3,3,8,3,3,10,8,8,10,10,8,8,10,10,10,8,8,8,10,10,10,8,3,3,3,3,3,3,3,3,3,3,3,3,3,8,10,3,3,3,3,3,3,3,3,3,3,3,3,3,3,3,3
3,3,3,3,3,3,3,3,3,3,3,3,3,3,3,3,0,0,0,0,0,0,0,0,0,0,0,0,0,0,0,0,0,0,0,0,0,0,0,0,0,0,0,0,0,0,0,0,0,0,0,0,0,0,0,0,0,0,0,0,0,0,0,0,0,0,0,0,0,0,0,0,0,0,0,0,0,0,0,0,0,0,0,0,0,0,0,0,0,0,0,0,0,0,0,0,0,0,0,0,0,0,0,0,0,0,0,0,0,0,0,0,0,0,0,0,0,0,0,0,0,0,0,0,0,0,0,0,0,0,0,0,0,0,0,0,0,0,0,0,0,0,0,0,0,0,0,0,0,0,0,0,0,0,0,0,0,0,0,0,0,0,0,0,0,0,0,0,0,0,0,0,0,0,0,0,0,0,0,0,0,0,0,0,0,0,0,0,0,0,0,0,0,0,0,0,0,0,0,0,0,0,0,0,0,0,0,0,0,0,0,0,0,0,0,0,0,0,0,0,0,0,0,0,0,0,0,0,0,0,0,0,0,0,0,0,0,0,0,0,0,0,0,0,0,0,0,0,0,0,0,0,0,0,0,0
3,3,3,8,3,3,3,3,3,8,3,3,3,3,8,3,0,0,0,0,0,0,0,0,0,0,0,0,0,0,0,0,0,0,0,0,0,0,0,0,0,0,0,0,0,0,0,0,0,0,0,0,0,0,0,0,0,0,0,0,0,0,0,0,0,0,0,0,0,0,0,0,0,0,0,0,0,0,0,0,0,0,0,0,0,0,0,0,0,0,0,0,0,0,0,0,0,0,0,0,0,0,0,0,0,0,0,0,0,0,0,0,0,0,0,0,0,0,0,0,0,0,0,0,0,0,0,0,0,0,0,0,0,0,0,0,0,0,0,0,0,0,0,0,0,0,0,0,0,0,0,0,0,0,0,0,0,0,0,0,0,0,0,0,0,0,0,0,0,0,0,0,0,0,0,0,0,0,0,0,0,0,0,0,0,0,0,0,0,0,0,0,0,0,0,0,0,0,0,0,0,0,0,0,0,0,0,0,0,0,0,0,0,0,0,0,0,0,0,0,0,0,0,0,0,0,0,0,0,0,0,0,0,0,0,0,0,0,0,0,0,0,0,0,0,0,0,0,0,0,0,0,0,0,0,0
3,3,3,3,3,8,3,3,3,8,3,3,3,3,8,3,0,0,0,0,0,0,0,0,0,0,0,0,0,0,0,0,0,0,0,0,0,0,0,0,0,0,0,0,0,0,0,0,0,0,0,0,0,0,0,0,0,0,0,0,0,0,0,0,0,0,0,0,0,0,0,0,0,0,0,0,0,0,0,0,0,0,0,0,0,0,0,0,0,0,0,0,0,0,0,0,0,0,0,0,0,0,0,0,0,0,0,0,0,0,0,0,0,0,0,0,0,0,0,0,0,0,0,0,0,0,0,0,0,0,0,0,0,0,0,0,0,0,0,0,0,0,0,0,0,0,0,0,0,0,0,0,0,0,0,0,0,0,0,0,0,0,0,0,0,0,0,0,0,0,0,0,0,0,0,0,0,0,0,0,0,0,0,0,0,0,0,0,0,0,0,0,0,0,0,0,0,0,0,0,0,0,0,0,0,0,0,0,0,0,0,0,0,0,0,0,0,0,0,0,0,0,0,0,0,0,0,0,0,0,0,0,0,0,0,0,0,0,0,0,0,0,0,0,0,0,0,0,0,0,0,0,0,0,0,0
3,3,8,3,3,8,3,3,3,8,3,3,3,3,3,3,0,0,0,0,0,0,0,0,0,0,0,0,0,0,0,0,0,0,0,0,0,0,0,0,0,0,0,0,0,0,0,0,0,0,0,0,0,0,0,0,0,0,0,0,0,0,0,0,0,0,0,0,0,0,0,0,0,0,0,0,0,0,0,0,0,0,0,0,0,0,0,0,0,0,0,0,0,0,0,0,0,0,0,0,0,0,0,0,0,0,0,0,0,0,0,0,0,0,0,0,0,0,0,0,0,0,0,0,0,0,0,0,0,0,0,0,0,0,0,0,0,0,0,0,0,0,0,0,0,0,0,0,0,0,0,0,0,0,0,0,0,0,0,0,0,0,0,0,0,0,0,0,0,0,0,0,0,0,0,0,0,0,0,0,0,0,0,0,0,0,0,0,0,0,0,0,0,0,0,0,0,0,0,0,0,0,0,0,0,0,0,0,0,0,0,0,0,0,0,0,0,0,0,0,0,0,0,0,0,0,0,0,0,0,0,0,0,0,0,0,0,0,0,0,0,0,0,0,0,0,0,0,0,0,0,0,0,0,0,0
3,3,8,3,3,3,8,3,3,3,8,3,3,8,3,3,0,0,0,0,0,0,0,0,0,0,0,0,0,0,0,0,0,0,0,0,0,0,0,0,0,0,0,0,0,0,0,0,0,0,0,0,0,0,0,0,0,0,0,0,0,0,0,0,0,0,0,0,0,0,0,0,0,0,0,0,0,0,0,0,0,0,0,0,0,0,0,0,0,0,0,0,0,0,0,0,0,0,0,0,0,0,0,0,0,0,0,0,0,0,0,0,0,0,0,0,0,0,0,0,0,0,0,0,0,0,0,0,0,0,0,0,0,0,0,0,0,0,0,0,0,0,0,0,0,0,0,0,0,0,0,0,0,0,0,0,0,0,0,0,0,0,0,0,0,0,0,0,0,0,0,0,0,0,0,0,0,0,0,0,0,0,0,0,0,0,0,0,0,0,0,0,0,0,0,0,0,0,0,0,0,0,0,0,0,0,0,0,0,0,0,0,0,0,0,0,0,0,0,0,0,0,0,0,0,0,0,0,0,0,0,0,0,0,0,0,0,0,0,0,0,0,0,0,0,0,0,0,0,0,0,0,0,0,0,0
3,3,8,3,3,3,8,3,3,3,3,8,3,8,3,3,0,0,0,0,0,0,0,0,0,0,0,0,0,0,0,0,0,0,0,0,0,0,0,0,0,0,0,0,0,0,0,0,0,0,0,0,0,0,0,0,0,0,0,0,0,0,0,0,0,0,0,0,0,0,0,0,0,0,0,0,0,0,0,0,0,0,0,0,0,0,0,0,0,0,0,0,0,0,0,0,0,0,0,0,0,0,0,0,0,0,0,0,0,0,0,0,0,0,0,0,0,0,0,0,0,0,0,0,0,0,0,0,0,0,0,0,0,0,0,0,0,0,0,0,0,0,0,0,0,0,0,0,0,0,0,0,0,0,0,0,0,0,0,0,0,0,0,0,0,0,0,0,0,0,0,0,0,0,0,0,0,0,0,0,0,0,0,0,0,0,0,0,0,0,0,0,0,0,0,0,0,0,0,0,0,0,0,0,0,0,0,0,0,0,0,0,0,0,0,0,0,0,0,0,0,0,0,0,0,0,0,0,0,0,0,0,0,0,0,0,0,0,0,0,0,0,0,0,0,0,0,0,0,0,0,0,0,0,0,0
3,3,8,3,3,3,3,8,3,3,3,8,3,3,3,3,0,0,0,0,0,0,0,0,0,0,0,0,0,0,0,0,0,0,0,0,0,0,0,0,0,0,0,0,0,0,0,0,0,0,0,0,0,0,0,0,0,0,0,0,0,0,0,0,0,0,0,0,0,0,0,0,0,0,0,0,0,0,0,0,0,0,0,0,0,0,0,0,0,0,0,0,0,0,0,0,0,0,0,0,0,0,0,0,0,0,0,0,0,0,0,0,0,0,0,0,0,0,0,0,0,0,0,0,0,0,0,0,0,0,0,0,0,0,0,0,0,0,0,0,0,0,0,0,0,0,0,0,0,0,0,0,0,0,0,0,0,0,0,0,0,0,0,0,0,0,0,0,0,0,0,0,0,0,0,0,0,0,0,0,0,0,0,0,0,0,0,0,0,0,0,0,0,0,0,0,0,0,0,0,0,0,0,0,0,0,0,0,0,0,0,0,0,0,0,0,0,0,0,0,0,0,0,0,0,0,0,0,0,0,0,0,0,0,0,0,0,0,0,0,0,0,0,0,0,0,0,0,0,0,0,0,0,0,0,0
3,3,3,3,3,3,3,3,3,3,3,3,3,3,3,3,0,0,0,0,0,0,0,0,0,0,0,0,0,0,0,0,0,0,0,0,0,0,0,0,0,0,0,0,0,0,0,0,0,0,0,0,0,0,0,0,0,0,0,0,0,0,0,0,0,0,0,0,0,0,0,0,0,0,0,0,0,0,0,0,0,0,0,0,0,0,0,0,0,0,0,0,0,0,0,0,0,0,0,0,0,0,0,0,0,0,0,0,0,0,0,0,0,0,0,0,0,0,0,0,0,0,0,0,0,0,0,0,0,0,0,0,0,0,0,0,0,0,0,0,0,0,0,0,0,0,0,0,0,0,0,0,0,0,0,0,0,0,0,0,0,0,0,0,0,0,0,0,0,0,0,0,0,0,0,0,0,0,0,0,0,0,0,0,0,0,0,0,0,0,0,0,0,0,0,0,0,0,0,0,0,0,0,0,0,0,0,0,0,0,0,0,0,0,0,0,0,0,0,0,0,0,0,0,0,0,0,0,0,0,0,0,0,0,0,0,0,0,0,0,0,0,0,0,0,0,0,0,0,0,0,0,0,0,0,0
SpriteSpeccyBlock,0,2,32
7,0,1,7,0,1,7,0,1,7,0,1,7,0,1,7,0,1,7,0,1,7,0,1,0,0,0,0,0,0,0,0,0,0,0,0,0,0,0,0,0,0,0,0,0,0,0,0,0,0,0,0,0,0,0,0,0,0,0,0,0,0,0,0,0,0,0,0,0,0,0,0,0,0,0,0,0,0,0,0,0,0,0,0,0,0,0,0,0,0,0,0,0,0,0,0
7,0,1,7,0,1,7,0,1,7,0,1,7,0,1,7,0,1,7,0,1,7,0,1,0,0,0,0,0,0,0,0,0,0,0,0,0,0,0,0,0,0,0,0,0,0,0,0,0,0,0,0,0,0,0,0,0,0,0,0,0,0,0,0,0,0,0,0,0,0,0,0,0,0,0,0,0,0,0,0,0,0,0,0,0,0,0,0,0,0,0,0,0,0,0,0
SpriteAttribs,0,0,0,0
HspriteSize,16,16
SpriteDataOffSet,&180
SpriteNotes,Start
This is a free text box for your notes... it's saved with the sprites

SpriteNotes,End
eof
